ID	Group
AAA1	AAA
AAA2	AAA
AAA3	AAA
AAA4	AAA
AAA5	AAA
BBB1	BBB
BBB2	BBB
BBB3	BBB
BBB4	BBB
BBB5	BBB
